1111111111111
1E00000000001
1110100C00001
10C01000000P1
1111111111111