1111111111111
11C10C00010C1
1100P11101111
1C0111E000001
1111111111111