1111111111111111111111111111111111111111111111
1C100000000000000000000000111111111E1111111111
10101011110000000000000000100000000000000000C1
101000111100000000C000000010111111111111111111
10111111110000000000000000100000000000000000C1
1000000011001111111111111111111101111101111101
1111111011001111111110000000000000001001000101
10000C100P001C00000000111111111111101111010101
1111111111111111111111111111111111111111111111