111111111111111111111111111111
1C10000000001111111E1111111111
1010101111000000100000000000C1
101000111100000000C00010111111
1011111111000100000000000000C1
1000000C110011111111P111110101
101111101100111111110000100101
10000C1000001C0000000101010101
111111111111111111111111111111