1111111111111111111111111
1C110C11110000000000000E1
1011000111010111111011101
1000010000010000001C1C101
1111111111111111101110101
1P000000000000000000001C1
1111111111111111111111111