1111111111111
1P000001000M1
101111C101001
1010011101111
101C0000000M1
1001110011111
1M000000000E1
1111111111111